State,Unemployment
AL,1000000
AR,1000000
CO,1000000
HI,1000000
IL,1000000
KS,1000000
KY,1000000
ME,1000000
MI,1000000
MT,1000000
NC,1000000
ND,1000000
OH,1000000
OR,1000000
PA,1000000
SD,1000000
TX,1000000
VT,1000000
VA,1000000
WA,1000000
WY,1000000
AZ,10
CA,10
FL,10
GA,10
ID,10
IN,10
IA,10
LA,10
MN,10
MS,10
NE,10
TN,10
UT,10
WI,10
