State,Unemployment
AL,1000000
AZ,1000000
AR,1000000
CA,1000000
CO,1000000
FL,1000000
ID,1000000
IL,1000000
IN,1000000
IA,1000000
KS,1000000
KY,1000000
ME,1000000
MI,1000000
MN,1000000
MS,1000000
MT,1000000
NE,1000000
ND,1000000
OH,1000000
PA,1000000
SD,1000000
TN,1000000
UT,1000000
VT,1000000
VA,1000000
WI,1000000
WY,1000000
GA,10
HI,10
LA,10
NC,10
OR,10
TX,10
WA,10
